{
  "levels": [
    {
      "id": 0,
      "name": "Волна",
      "rows": 6,
      "cols": 8,
      "walls": [
        {"x": 1, "y": 1},
        {"x": 2, "y": 2},
        {"x": 3, "y": 1},
        {"x": 5, "y": 1},
        {"x": 5, "y": 2},
        {"x": 4, "y": 3},
        {"x": 0, "y": 5}
      ],
      "start": {"x": 0, "y": 0},
      "exit": {"x": 0, "y": 1},
      "teleport": {"x": 3, "y": 3}
    },
    {
      "id": 1,
      "name": "Лабиринт",
      "rows": 7,
      "cols": 9,
      "walls": [
        {"x": 1, "y": 1},
        {"x": 1, "y": 2},
        {"x": 1, "y": 3},
        {"x": 0, "y": 5},
        {"x": 1, "y": 5},
        {"x": 1, "y": 6},
        {"x": 3, "y": 6},
        {"x": 4, "y": 5},
        {"x": 5, "y": 4},
        {"x": 6, "y": 3},
        {"x": 4, "y": 1},
        {"x": 5, "y": 2}
      ],
      "start": {"x": 0, "y": 0},
      "exit": {"x": 0, "y": 1}
    },
    {
      "id": 2,
      "name": "Крепость",
      "rows": 8,
      "cols": 10,
      "walls": [
        {"x": 3, "y": 1},
        {"x": 0, "y": 5},
        {"x": 0, "y": 6},
        {"x": 0, "y": 7},
        {"x": 1, "y": 5},
        {"x": 1, "y": 6},
        {"x": 1, "y": 7},
        {"x": 2, "y": 7},
        {"x": 4, "y": 5},
        {"x": 5, "y": 5},
        {"x": 5, "y": 6},
        {"x": 6, "y": 2},
        {"x": 7, "y": 2},
        {"x": 8, "y": 2},
        {"x": 8, "y": 3},
        {"x": 8, "y": 4}
      ],
      "start": {"x": 1, "y": 2},
      "exit": {"x": 1, "y": 3}
    },
    {
      "id": 3,
      "name": "Спираль",
      "rows": 9,
      "cols": 9,
      "walls": [
        {"x": 1, "y": 1},
        {"x": 3, "y": 0},
        {"x": 4, "y": 0},
        {"x": 5, "y": 0},
        {"x": 6, "y": 0},
        {"x": 7, "y": 0},
        {"x": 8, "y": 0},
        {"x": 8, "y": 1},
        {"x": 8, "y": 2},
        {"x": 7, "y": 3},
        {"x": 4, "y": 4},
        {"x": 5, "y": 3},
        {"x": 6, "y": 3},
        {"x": 6, "y": 4},
        {"x": 6, "y": 5},
        {"x": 5, "y": 6},
        {"x": 4, "y": 7},
        {"x": 3, "y": 7},
        {"x": 2, "y": 7}
      ],
      "start": {"x": 0, "y": 4},
      "exit": {"x": 0, "y": 3}
    },
    {
      "id": 4,
      "name": "Финал",
      "rows": 9,
      "cols": 9,
      "walls": [
        {"x": 3, "y": 0},
        {"x": 4, "y": 0},
        {"x": 5, "y": 0},
        {"x": 5, "y": 1},
        {"x": 6, "y": 0},
        {"x": 7, "y": 0},
        {"x": 8, "y": 0},
        {"x": 8, "y": 1},
        {"x": 8, "y": 2},
        {"x": 0, "y": 6},
        {"x": 0, "y": 7},
        {"x": 0, "y": 8},
        {"x": 1, "y": 6},
        {"x": 1, "y": 7},
        {"x": 2, "y": 6},
        {"x": 1, "y": 4},
        {"x": 2, "y": 3},
        {"x": 3, "y": 4},
        {"x": 3, "y": 8},
        {"x": 4, "y": 8},
        {"x": 5, "y": 8},
        {"x": 5, "y": 6},
        {"x": 6, "y": 5},
        {"x": 7, "y": 7},
        {"x": 7, "y": 6},
        {"x": 8, "y": 8}
      ],
      "start": {"x": 7, "y": 2},
      "exit": {"x": 7, "y": 3}
    }
  ]
}